1,1,1,1,1,1,1,1,1,1
1,1,1,1,1,1,1,1,1,1
1,1,1,1,1,1572873,1572866,1572870,1,1
1,1,1,1,1,1572869,1572865,1572867,1,1
1,1572873,1572866,1572870,1,1572872,1572868,1572871,1,1
1,1572869,1572865,1572867,1,1,1,1,1,1
1,1572872,1572868,1572871,1,1,1572873,1572866,1572870,1
1,1,1,1,1,1,1572869,1572865,1572867,1
1,1,1,1,1,1,1572872,1572868,1572871,1
1,1,1,1,1,1,1,1,1,1